11111111111111111111
10000000000000000001
10000000000000000001
10000000000000000001
10000000000000000001
10000000000000000001
10000000000000000001
10000000000000000001
10000000000000000001
10000001010011000001
10000010000000000001
10000100001100001001
00001000000000000001
00010000010000000001
11111111111111111111